version https://git-lfs.github.com/spec/v1
oid sha256:5fafedada87085dd3f1b3fb5fa2746c629eb56d116948d24df29f70359b5316c
size 35449
